111333333333333333333333333333333333333333333333333AAA
111333333333333333333333333333333333333333333333333AAA
111333333333333333333333333333333333333333333333333AAA
222444444444444444444444444444444444444444444444444DDD
222444444444444444444444444444444444444444444444444DDD
222440000000670000000000000000000000000067000000044DDD
222440000000670000000000000000000000000067000000044DDD
222440000000670000000000000000000000000067000000044DDD
222440000000670000000000000000000000000067000000044DDD
222440000000670000000000000000000000000067000000044DDD
222440000000670000000000000000000000000067000000044DDD
2224400000006700000000133333333A0000000067000000044DDD
2224400000006700000000F55555555B0000000067000000044DDD
222440000000670000000000000000000000000067000000044DDD
222440000000670000000000000000000000000067000000044DDD
222440000000670000000000000000000000000067000000044DDD
222440000000670000000000000000000000000067000000044DDD
222440000000670000000000000000000000000067000000044DDD
222440000000670000000000000000000000000067000000044DDD
222440000000670000000000000000000000000067000000044DDD
222440000000000000000000000000000000000000000000044DDD
222440000000000000000000000000000000000000000000044DDD
222440000000000000000000000000000000000000000000044DDD
222440000000000000000000000000000000000000000000044DDD
222440000000000000000000000000000000000000000000044DDD
222440000000000000000000000000000000000000000000044DDD
222440000000670000000000000000000000000000000000044DDD
222440000000670000000000000000000000000067000000044DDD
222440000000670000000000000000000000000067000000044DDD
222440000000670000000000000000000000000067000000044DDD
222440000000670000000000000000000000000067000000044DDD
222440000000670000000000000000000000000067000000044DDD
222440000000870000000000000000000000000087000000044DDD
222440000000870000000000000000000000000087000000044DDD
222440000000870000000000000000000000000087000000044DDD
222440000000670000000000000000000000000067000000044DDD
222440000000670000000000000000000000000067000000044DDD
222440000000670000000000000000000000000067000000044DDD
222440000000670000000000000000000000000067000000044DDD
222440000000670000000000000000000000000067000000044DDD
222440000000670000000000000000000000000067000000044DDD
2224400000006700000000133333333A0000000067000000044DDD
2224400000006700000000F55555555B0000000067000000044DDD
222440000000670000000000000000000000000067000000044DDD
222440000000670000000000000000000000000067000000044DDD
2224400000006700000000000000000000C0000067000000044DDD
2224400000006700000000000000000000CC0C0067000000044DDD
2224400000006700000000000000000000CCCC0067000000044DDD
2224400000006700000000000000000000CCCC0067000000044DDD
222444444444444444444444444444444444444444444444444DDD
222444444444444444444444444444444444444444444444444DDD
EEE555555555555555555555555555555555555555555555555BBB
EEE555555555555555555555555555555555555555555555555BBB
EEE555555555555555555555555555555555555555555555555BBB